+++++++++++++++++++++++++
.........................
..=......................
.........................
.........................
.........................
.........................
.........................
+++++++++++++++++++++++++