##################
#________________#
#________________#
#________________#
#________________#
#________________#
#________________#
#________________#
#________________#
#________________#
########___#######